road

00,00,00,03,23,01,01,01,01,01-00,00,00,03,23,01,01,01,01,01-00,00,00,03,23,01,01,01,01,01-00,00,00,03,44,22,00,00,00,00-00,00,00,03,13,23,00,00,00,00-00,00,00,03,13,23,00,10,00,00-00,00,00,03,45,24,00,00,00,00-12,12,12,34,23,00,00,00,00,00-14,14,14,35,23,00,00,00,00,00-00,00,00,03,23,00,00,00,00,00

1
Street

03,23,0,00,00,00,0,00,00,00,00,00,00,00,00,00,716,00,00,00-03,23,0,00,00,00,0,00,00,00,00,00,00,00,00,00,718,00,00,00-03,23,00,00,00,00,00,00,00,00,00,00,00,00,00,00,00,00,00,00-03,23,00,1118,1118,1118,00,00,00,00,00,00,00,00,00,00,00,00,00,00-03,23,00,0,0,0,0,0,0,0,0,0,0,0,0,0,0,00,00,00-03,23,00,0,0,0,00,0,0,0,0,0,00,0,0,0,0,00,00,00-03,23,00,1122,0,0,00,00,0,0,0,00,00,0,0,0,00,00,00,00-34,44,12,13,12,12,12,12,12,12,13,12,12,13,12,12,12,12,12,12-14,14,14,14,14,14,14,14,14,14,35,45,14,14,14,14,14,14,14,14-00,00,00,00,00,00,00,00,00,00,03,23,08,18,18,18,18,18,28,00-00,00,00,00,00,00,00,0,0,0,03,23,010,110,110,110,110,110,210,00-00,00,00,00,00,00,00,0,0,0,04,24,00,00,00,00,00,00,00,00-00,00,00,00,00,00,00,0,0,0,00,00,00,00,00,00,00,00,00,00-00,00,00,00,00,00,00,00,00,00,00,00,00,00,00,00,00,00,00,00-01,01,01,00,00,00,00,00,00,00,00,00,00,00,00,00,00,00,00,00

1
undefined

00,00,00,00,00,00,00,00,00,00,00,00,00,00,00-00,00,00,00,00,00,00,00,00,00,00,00,00,00,00-00,00,00,00,00,00,00,00,00,00,00,00,00,00,00-00,00,00,00,00,00,00,00,00,00,00,00,00,00,00-00,0,0,0,0,0,0,0,0,0,00,00,00,00,00-00,0,0,0,0,0,0,0,0,0,0,0,0,0,00-00,0,0,0,0,00,0,0,0,0,0,0,0,0,00-00,0,00,0,0,00,0,0,0,00,0,0,0,0,00-00,0,00,0,undefined,00,0,undefined,0,00,0,0,0,0,00-00,0,00,0,0,00,0,0,0,00,0,0,0,0,00-00,0,00,00,00,00,3367,0,0,00,0,0,0,0,00-00,0,00,undefined,0,00,0,0,undefined,00,0,0,0,0,00-00,0,00,0,undefined,00,0,undefined,0,00,0,0,0,0,00-00,0,0,0,0,undefined,undefined,0,0,0,0,0,0,0,00-00,00,00,00,00,00,00,00,00,00,00,00,00,00,00

1


0,0,0,0,0,0,0,0,0,0,0,0,0,0,0,0,0,0,0,0,0,0,0,0,0-0,0,0,0,0,0,0,0,0,0,0,0,0,0,0,0,0,0,0,0,0,0,0,0,0-0,0,0,0,0,0,0,0,0,0,0,0,0,0,0,0,0,0,0,0,0,0,0,0,0-0,0,0,0,0,0,0,0,0,0,0,0,0,0,0,0,0,0,0,0,0,0,0,0,0-0,0,0,0,0,0,0,0,0,0,0,0,0,0,0,0,0,0,0,0,0,0,0,0,0-0,0,0,0,0,0,0,0,0,0,0,0,0,0,0,0,0,0,0,0,0,0,0,0,0-0,0,0,0,0,0,0,0,0,0,0,0,0,0,0,0,0,0,0,0,0,0,0,0,0-0,0,0,0,0,0,0,0,0,0,0,0,0,0,0,0,0,0,0,0,0,0,0,0,0-0,0,0,0,0,0,0,0,0,0,0,0,0,0,0,0,0,0,0,0,0,0,0,0,0-0,0,0,0,0,0,0,0,0,0,0,0,0,0,0,0,0,0,0,0,0,0,0,0,0-0,0,0,0,0,0,0,0,0,0,0,0,0,0,0,0,0,0,0,0,0,0,0,0,0-0,0,0,0,0,0,0,0,0,0,0,0,0,0,0,0,0,0,0,0,0,0,0,0,0-0,0,0,0,0,0,0,0,0,0,0,0,0,0,0,0,0,0,0,0,0,0,0,0,0-0,0,0,0,0,0,0,0,0,0,0,0,0,0,0,0,0,0,0,0,0,0,0,0,0-0,0,0,0,0,0,0,0,0,0,0,0,0,0,0,0,0,0,0,0,0,0,0,0,0-0,0,0,0,0,0,0,0,0,0,0,0,0,0,0,0,0,0,0,0,0,0,0,0,0-0,0,0,0,0,0,0,0,0,0,0,0,0,0,0,0,0,0,0,0,0,0,0,0,0-0,0,0,0,0,0,0,0,0,0,0,0,0,0,0,0,0,0,0,0,0,0,0,0,0-0,0,0,0,0,0,0,0,0,0,0,0,0,0,0,0,0,0,0,0,0,0,0,0,0-0,0,0,0,0,0,0,0,0,0,0,0,0,0,0,0,0,0,0,0,0,0,0,0,0-0,0,0,0,0,0,0,0,0,0,0,0,0,0,0,0,0,0,0,0,0,0,0,0,0-0,0,0,0,0,0,0,0,0,0,0,0,0,0,0,0,0,0,0,0,0,0,0,0,0-0,0,0,0,0,0,0,0,0,0,0,0,0,0,0,0,0,0,0,0,0,0,0,0,0-0,0,0,0,0,0,0,0,0,0,0,0,0,0,0,0,0,0,0,0,0,0,0,0,0-0,0,0,0,0,0,0,0,0,0,0,0,0,0,0,0,0,0,0,0,0,0,0,0,0

1
25x25GrassDontEdit

00,00,00,00,00,00,00,00,00,00,00,00,00,00,00,00,00,00,00,00,00,00,00,00,00-00,00,00,00,00,00,00,00,00,00,00,00,00,00,00,00,00,00,00,00,00,00,00,00,00-00,00,00,00,00,00,00,00,00,00,00,00,00,00,00,00,00,00,00,00,00,00,00,00,00-00,00,00,00,00,00,00,00,00,00,00,00,00,00,00,00,00,00,00,00,00,00,00,00,00-00,00,00,00,00,00,00,00,00,00,00,00,00,00,00,00,00,00,00,00,00,00,00,00,00-00,00,00,00,00,00,00,00,00,00,00,00,00,00,00,00,00,00,00,00,00,00,00,00,00-00,00,10,00,00,00,00,00,00,00,00,00,00,00,00,00,00,00,00,00,00,00,00,00,00-00,00,00,00,00,00,00,00,00,00,00,00,00,00,00,00,00,00,00,00,00,00,00,00,00-00,00,10,00,00,00,00,00,00,00,00,00,00,00,00,00,00,00,00,00,00,00,00,00,00-00,00,00,00,00,00,00,00,00,00,00,00,00,00,00,00,00,00,00,00,00,00,00,10,00-00,00,00,00,00,00,00,00,00,00,00,00,00,00,00,00,00,00,00,00,00,00,00,00,00-00,10,00,00,00,00,00,00,00,00,00,00,00,00,00,00,00,00,00,00,00,00,00,00,00-00,00,00,00,00,00,00,00,00,00,00,00,00,00,00,00,00,00,00,00,00,00,00,00,00-00,00,00,00,00,00,00,00,00,00,00,00,00,00,00,00,00,00,00,00,00,00,00,00,00-00,10,00,00,00,00,00,00,00,00,00,00,00,00,00,00,00,00,00,00,00,00,00,00,10-00,00,10,00,00,00,00,00,00,00,00,00,00,00,00,00,00,00,00,00,00,00,00,00,00-00,00,10,00,00,00,00,00,00,00,00,00,00,00,00,00,00,00,00,00,00,00,00,00,00-00,00,10,00,00,00,00,00,00,00,00,00,00,00,00,00,00,00,00,00,00,00,00,00,00-00,10,00,00,00,00,00,00,00,00,00,00,00,00,00,00,00,00,00,00,00,00,10,10,00-00,00,01,00,00,00,00,00,00,00,00,00,00,00,00,00,00,00,00,00,00,00,00,10,00-00,00,00,00,00,00,00,00,00,00,00,00,00,00,00,00,00,00,00,00,00,00,00,00,00-01,00,00,00,00,00,00,00,00,00,00,00,00,00,00,00,00,00,00,00,00,00,00,00,00-00,00,00,00,00,00,00,00,00,00,00,00,00,00,00,00,00,00,00,00,00,00,00,00,00-00,68,78,00,00,00,00,00,00,00,00,00,00,00,00,00,00,00,00,00,00,00,00,00,00-00,00,00,00,00,00,00,00,00,00,00,00,00,00,00,00,00,00,00,00,00,00,00,00,00

1
Test

0,0,0,0,0,0,0,0,0,0,0,0,0,0,0,0,0,0,0,0,0,0,0,0,0,0,0,0,0,0,0,0,0,0,0,0,0,0,0,0-0,0,0,0,0,0,0,0,0,0,0,0,0,0,0,0,0,0,0,0,0,0,0,0,0,0,0,0,0,0,0,0,0,0,0,0,0,0,0,0-0,0,0,0,0,0,0,0,0,0,0,0,0,0,0,0,0,0,0,0,0,0,0,0,0,0,0,0,0,0,0,0,0,0,0,0,0,0,0,0-0,0,0,0,0,0,0,0,0,0,0,0,0,0,0,0,0,0,0,0,0,0,0,0,0,0,0,0,0,0,0,0,0,0,0,0,0,0,0,0-0,0,0,0,0,0,0,0,0,0,0,0,0,0,0,0,0,0,0,0,0,0,0,0,0,0,0,0,0,0,0,0,0,0,0,0,0,0,0,0-0,0,0,0,0,0,0,0,0,0,0,0,0,0,0,0,0,0,0,0,0,0,0,0,0,0,0,0,0,0,0,0,0,0,0,0,0,0,0,0-0,0,0,0,0,0,0,0,0,0,0,0,0,0,0,0,0,0,0,0,0,0,0,0,0,0,0,0,0,0,0,0,0,0,0,0,0,0,0,0-0,0,0,0,0,0,0,0,0,0,0,0,0,0,0,0,0,0,0,0,0,0,0,0,0,0,0,0,0,0,0,0,0,0,0,0,0,0,0,0-0,0,0,0,0,0,0,0,0,0,0,0,0,0,0,0,0,0,0,0,0,0,0,0,0,0,0,0,0,0,0,0,0,0,0,0,0,0,0,0-0,0,0,0,0,0,0,0,0,0,0,0,0,0,0,0,0,0,0,0,0,0,0,0,0,0,0,0,0,0,0,0,0,0,0,0,0,0,0,0-0,0,0,0,0,0,0,0,0,0,0,0,0,0,0,0,0,0,0,0,0,0,0,0,0,0,0,0,0,0,0,0,0,0,0,0,0,0,0,0-0,0,0,0,0,0,0,0,0,0,0,0,0,0,0,0,0,0,0,0,0,0,0,0,0,0,0,0,0,0,0,0,0,0,0,0,0,0,0,0-0,0,0,0,0,0,0,0,0,0,0,0,0,0,0,0,0,0,0,0,0,0,0,0,0,0,0,0,0,0,0,0,0,0,0,0,0,0,0,0-0,0,0,0,0,0,0,0,0,0,0,0,0,0,0,0,0,0,0,0,0,0,0,0,0,0,0,0,0,0,0,0,0,0,0,0,0,0,0,0-0,0,0,0,0,0,0,0,0,0,0,0,0,0,0,0,0,0,0,0,0,0,0,0,0,0,0,0,0,0,0,0,0,0,0,0,0,0,0,0-0,0,0,0,0,0,0,0,0,0,0,0,0,0,0,0,0,0,0,0,0,0,0,0,0,0,0,0,0,0,0,0,0,0,0,0,0,0,0,0-0,0,0,0,0,0,0,0,0,0,0,0,0,0,0,0,0,0,0,0,0,0,0,0,0,0,0,0,0,0,0,0,0,0,0,0,0,0,0,0-0,0,0,0,318,418,418,0,0,0,0,0,0,0,0,0,0,0,0,0,0,0,0,0,0,0,0,0,0,0,0,0,0,0,0,0,0,0,0,0-0,0,0,0,318,418,418,0,0,0,0,0,0,0,0,0,0,0,0,0,0,0,0,0,0,0,0,0,0,0,0,0,0,0,0,0,0,0,0,0-0,0,0,0,318,418,418,0,0,0,0,0,0,0,0,0,0,0,0,0,0,0,0,0,0,0,0,0,0,0,0,0,0,0,0,0,0,0,0,0-0,0,0,0,318,418,418,0,0,0,0,0,0,0,0,0,0,0,0,0,0,0,0,0,0,0,0,0,0,0,0,0,0,0,0,0,0,0,0,0-0,0,0,0,318,418,418,0,0,0,0,0,0,0,0,0,0,0,0,0,0,0,0,0,0,0,0,0,0,0,0,0,0,0,0,0,0,0,0,0-0,0,0,0,318,418,418,0,0,0,0,0,0,0,0,0,0,0,0,0,0,0,0,0,0,0,0,0,0,0,0,0,0,0,0,0,0,0,0,0-0,0,0,0,318,418,418,0,0,0,0,0,0,0,0,0,0,0,0,0,0,0,0,0,0,0,0,0,0,0,0,0,0,0,0,0,0,0,0,0-0,0,0,0,318,418,418,0,0,0,0,0,0,0,0,0,0,0,0,0,0,0,0,0,0,0,0,0,0,0,0,0,0,0,0,0,0,0,0,0-0,0,0,0,318,418,418,0,0,0,0,0,0,0,0,0,0,0,0,0,0,0,0,0,0,0,0,0,0,0,0,0,0,0,0,0,0,0,0,0-0,0,0,0,318,418,418,0,0,0,0,0,0,0,0,0,0,0,0,0,0,0,0,0,0,0,0,0,0,0,0,0,0,0,0,0,0,0,0,0-0,0,0,0,318,418,418,0,0,0,0,0,0,0,0,0,0,0,0,0,0,0,0,0,0,0,0,0,0,0,0,0,0,0,0,0,0,0,0,0-0,0,0,0,318,418,418,0,0,0,0,0,0,0,0,0,0,0,0,0,0,0,0,0,0,0,0,0,0,0,0,0,0,0,0,0,0,0,0,0-0,0,0,0,318,418,418,0,0,0,0,0,0,0,0,0,0,0,0,0,0,0,0,0,0,0,0,0,0,0,0,0,0,0,0,0,0,0,0,0

1
roadmap

30,30,0,30,30,30,00,00,30,133,133,133,133,133,133,30,00,00,00,30,30,30,30,30,30-0,30,00,30,30,30,01,01,30,133,133,133,133,133,133,133,30,01,01,30,30,30,30,30,30-00,422,30,0,30,0,00,01,01,30,133,133,133,133,133,133,30,01,01,30,30,30,30,30,30-00,0,0,0,0,0,00,01,01,01,30,30,30,133,133,30,01,01,01,30,30,30,30,30,30-10,0,0,00,00,00,00,00,01,01,00,01,01,30,30,30,01,01,00,01,30,30,30,30,30-10,00,00,30,00,00,00,00,00,01,01,01,01,01,01,01,01,01,01,02,12,12,12,12,12-00,00,41,51,00,00,41,51,00,00,41,51,01,01,41,51,20,30,30,03,13,13,13,13,13-00,00,42,52,00,00,42,52,00,00,42,52,00,00,42,52,00,00,00,03,13,45,14,14,14-00,00,00,00,00,00,00,00,00,00,00,00,00,00,00,00,00,00,00,03,13,23,00,00,00-12,12,12,12,12,12,12,12,12,12,12,12,12,12,12,12,12,12,12,34,13,23,01,00,01-13,13,13,13,13,13,13,13,13,13,13,13,13,13,13,13,13,13,13,13,13,23,00,01,00-14,14,14,14,14,14,14,14,14,14,14,14,14,14,14,14,14,14,14,14,14,24,00,01,00-00,00,61,71,00,00,61,71,00,00,61,71,00,00,61,71,00,00,61,71,00,00,01,01,01-00,00,42,52,00,00,42,52,00,00,42,52,00,00,42,52,00,00,42,52,01,00,01,01,01-00,00,00,00,00,00,00,00,00,00,00,00,00,00,00,00,00,01,01,00,01,01,01,01,01

1
fork road

30,30,30,30,30,30,30,30,30,30,30,30,30,30,30-30,30,30,30,30,30,30,30,30,30,30,30,30,30,30-30,30,30,30,30,30,30,30,30,30,30,30,30,30,30-30,30,30,30,30,30,30,30,30,30,30,30,30,30,30-30,30,30,30,30,30,30,30,30,30,30,30,30,30,30-12,12,12,12,12,12,12,12,12,12,12,12,12,12,12-13,13,13,13,13,13,13,13,13,13,13,13,13,13,13-14,14,14,14,14,14,35,13,45,14,14,14,14,14,14-30,30,30,30,30,30,03,13,23,30,30,30,30,30,30-30,30,30,30,30,30,03,13,23,30,30,30,30,30,30-30,30,30,30,30,30,03,13,23,30,30,30,30,30,30-30,30,30,30,30,30,03,13,23,30,30,30,30,30,30-30,30,30,30,30,30,03,13,23,30,30,30,30,30,30-30,30,30,30,30,30,03,13,23,30,30,30,30,30,30-30,30,30,30,30,30,03,13,23,30,30,30,30,30,30-30,30,30,30,30,30,03,13,23,30,30,30,30,30,30-30,30,30,30,30,30,03,13,23,30,30,30,30,30,30-30,30,30,30,30,30,03,13,23,30,30,30,30,30,30-30,30,30,30,30,30,03,13,23,30,30,30,30,30,30-30,30,30,30,30,30,03,13,23,30,30,30,30,30,30-30,30,30,30,30,30,03,13,23,30,30,30,30,30,30-30,30,30,30,30,30,03,13,23,30,30,30,30,30,30-30,30,30,30,30,30,03,13,23,30,30,30,30,30,30-30,30,30,30,30,30,03,13,23,30,30,30,30,30,30-30,30,30,30,30,30,03,13,23,30,30,30,30,30,30

0
ShiroiField_1

6373,6373,6373,6373,6373,6373,6373,6373,6373,6373,6373,6373,6373,6373,6373-6373,6373,6373,6373,6373,6373,6373,6373,6373,5378,6378,6373,6373,6373,6373-6374,1371,1371,1371,6374,4374,1371,1371,1371,1371,6374,1371,1371,1371,1371-0373,1373,1373,1373,1373,1373,1373,1373,1373,0372,0372,0372,0372,0372,1372-0374,3371,3371,3371,3371,3371,3371,3371,3371,0372,0372,0372,0372,0372,1372-0374,3371,3371,3371,3371,3371,3371,3371,3371,0372,0372,0372,0372,0372,1372-0374,3371,3371,3371,3371,3371,3371,3371,3371,0372,0372,0372,0372,0372,1372-0374,3371,3371,3371,3371,3371,3371,3371,3371,0372,0372,0372,0372,0372,1372-0374,3371,3371,3371,3371,3371,3371,3371,3371,0372,0372,3371,0372,3371,1372-0374,3371,3371,3371,3371,3371,3371,3371,3371,0372,0372,0372,0372,0372,1372-0374,3371,3371,3371,3371,3371,3371,3371,6373,6373,6373,6373,6373,6373,6373-0374,3371,3371,3371,3371,3371,3371,3371,6374,6374,1393,6374,6374,6374,6374-0374,3371,3371,3371,3371,3371,3371,3371,3371,3371,3371,3371,3371,3371,2374-4371,3371,3371,3371,3371,4371,4371,4371,4371,3371,3371,3371,3371,3371,4371-4371,4371,4371,4371,4371,1371,1371,4371,4371,4371,4371,4371,4371,4371,4371

1
House

0,0,5377,6377,0,4373,4373,4373,5377,0-0,0,5378,0,0,4374,4374,4374,0,4374-5371,5371,5371,5371,5371,5371,5371,5371,5371,5371-5371,5371,5371,5371,5371,5371,5371,5371,5371,5371-5371,5371,5371,5371,5371,5371,5371,5371,5371,5371-5371,5371,5371,5371,5371,5371,5371,5371,5371,5371-5371,5371,5371,5371,5371,5371,5371,5371,5371,5371-5371,5371,5371,5371,5371,5371,5371,5371,5371,5371-5371,5371,5371,5371,5371,5371,5371,5371,5371,5371-5371,5371,5371,5371,5371,5371,5371,5371,5371,5371-5371,5371,5371,5371,5371,5371,5371,5371,5371,5371-5371,5371,5371,5371,5371,5371,5371,5371,5371,5371-5371,5371,5371,5371,5371,5371,5371,5371,5371,5371-5371,5371,5371,5371,5371,5371,5371,5371,5371,5371-5371,5371,5371,5371,6402,6402,5371,5371,5371,5371

1
fork_road

30,30,30,30,30,30,30,30,30,30,30,30,30,30,30-30,30,30,30,30,30,30,30,30,30,30,30,30,30,30-30,30,30,30,30,30,30,30,30,30,30,30,30,30,30-30,30,30,30,30,30,30,30,30,30,30,30,30,30,30-30,30,30,30,30,30,30,30,30,30,30,30,30,30,30-12,12,12,12,12,12,12,12,12,12,12,12,12,12,12-13,13,13,13,13,13,13,13,13,13,13,13,13,13,13-14,14,14,14,14,14,35,13,45,14,14,14,14,14,14-30,30,30,30,30,30,03,13,23,30,30,30,30,30,30-30,30,30,30,30,30,03,13,23,30,30,30,30,30,30-30,30,30,30,30,30,03,13,23,30,30,30,30,30,30-30,30,30,30,30,30,03,13,23,30,30,30,30,30,30-30,30,30,30,30,30,03,13,23,30,30,30,30,30,30-30,30,30,30,30,30,03,13,23,30,30,30,30,30,30-30,30,30,30,30,30,03,13,23,30,30,30,30,30,30-30,30,30,30,30,30,03,13,23,30,30,30,30,30,30-30,30,30,30,30,30,03,13,23,30,30,30,30,30,30-30,30,30,30,30,30,03,13,23,30,30,30,30,30,30-30,30,30,30,30,30,03,13,23,30,30,30,30,30,30-30,30,30,30,30,30,03,13,23,30,30,30,30,30,30-30,30,30,30,30,30,03,13,23,30,30,30,30,30,30-30,30,30,30,30,30,03,13,23,30,30,30,30,30,30-30,30,30,30,30,30,03,13,23,30,30,30,30,30,30-30,30,30,30,30,30,03,13,23,30,30,30,30,30,30-30,30,30,30,30,30,03,13,23,30,30,30,30,30,30

1
Shiroihouse_Room2

6373,6373,6373,6373,6373,6373,6373,6373,6373,6373,4373,4373,6373,6373,6373-673,673,673,673,673,673,673,673,673,4374,4374,4374,673,673,673-3371,1373,1373,1373,1373,1373,1373,1373,1373,1373,1373,1373,1373,1373,2373-7348,3371,3371,3371,3371,3371,3371,3371,3371,3371,3371,3371,3371,3371,2374-0374,3371,3371,3371,3371,3371,3371,3371,3371,3371,3371,3371,3371,3371,2374-0374,3371,3371,3371,3371,3371,3371,3371,3371,3371,3371,3371,3371,3371,2374-0374,3371,3371,3371,3371,3371,3371,3371,3371,3371,3371,3371,3371,3371,2374-0374,3371,3371,3371,3371,3371,3371,3371,3371,3371,3371,3371,3371,3371,4371-0374,3371,3371,3371,3371,3371,3371,3371,3371,3371,3371,3371,3371,3371,4371-0374,3371,3371,3371,3371,3371,3371,3371,3371,3371,3371,3371,3371,3371,4371-0374,3371,3371,3371,3371,3371,3371,3371,3371,3371,3371,3371,3371,3371,2374-0374,3371,3371,3371,3371,3371,3371,3371,3371,3371,3371,3371,3371,3371,2374-0374,3371,3371,3371,3371,3371,3371,3371,3371,3371,3371,3371,3371,3371,2374-0374,3371,3371,3371,3371,3371,3371,3371,3371,3371,3371,3371,3371,3371,2374-0374,3371,3371,3371,3371,3371,3371,3371,3371,3371,3371,3371,3371,3371,2374

1
GardenSenNunu

00,00,00,00,06,26,00,00,00,00-00,01,01,01,06,26,00,00,00,00-00,01,01,01,06,26,00,00,00,00-00,59,69,69,36,26,00,00,00,00-00,511,611,611,37,26,00,00,00,00-00,00,00,00,06,46,15,25,00,00-00,00,00,00,06,16,16,26,00,00-00,00,00,00,06,16,16,26,00,00-00,00,00,00,06,47,17,27,00,00-00,00,00,00,06,26,02,12,22,00-00,00,00,00,06,26,03,13,23,00-00,00,00,00,06,26,04,35,23,00-00,00,00,00,06,26,00,04,24,00-00,00,00,00,06,26,00,00,00,00-00,00,00,00,06,26,00,00,00,00

1
Blossom_town

10,10,10,10,10,10,10,03,23,10,10,10,10,10,20,20,20,20,20,20-10,10,10,10,10,10,10,03,23,10,30,10,10,30,10,10,30,10,10,20-10,10,10,30,10,10,30,631,731,10,10,10,10,20,10,10,10,10,10,20-10,10,10,10,10,10,10,03,23,10,10,10,10,10,10,10,30,10,30,20-12,12,12,12,12,12,12,34,23,00,00,00,10,10,10,10,10,10,10,20-14,14,14,14,35,45,14,14,24,10,10,10,10,10,10,10,10,30,10,10-10,10,10,30,03,23,30,30,30,30,10,30,30,30,00,30,30,30,10,20-10,01,01,00,03,23,30,30,30,30,30,30,30,30,30,10,30,30,30,20-10,10,01,30,03,23,10,30,30,30,30,30,10,30,30,30,30,30,30,10-10,10,01,30,03,23,30,30,30,30,30,30,30,30,30,30,30,30,30,10-10,30,30,30,03,44,12,12,12,12,12,12,13,12,12,22,30,10,30,10-10,10,30,10,04,14,14,14,14,13,14,14,35,45,14,24,30,30,30,10-10,01,30,30,30,30,30,30,30,13,30,30,03,23,30,30,30,30,30,10-01,01,30,30,10,30,30,59,69,69,79,10,03,23,30,30,30,30,30,10-01,01,10,30,30,30,30,610,610,610,710,30,03,23,30,10,30,30,30,10-10,30,30,30,30,10,30,511,611,611,711,30,04,24,30,30,30,30,30,10-10,30,30,30,30,30,30,30,30,30,30,10,30,30,10,30,30,30,30,10-10,30,10,30,30,30,30,30,30,30,10,30,30,30,30,10,30,10,30,72-10,30,30,30,30,30,10,30,30,30,30,30,10,30,30,30,30,30,30,10-10,10,10,10,10,10,10,10,10,10,10,10,10,10,10,10,10,10,10,10

1
GrassFieldDontEdit

10,10,10,10,10,10,10,10,10,10,10,10,10,10,20,20,20,20,20,20-10,10,10,10,10,10,10,10,10,10,30,10,10,30,10,10,30,10,10,20-10,10,10,30,10,10,30,10,10,10,10,10,10,20,10,10,10,10,10,20-10,10,10,10,10,10,10,10,10,10,10,10,10,10,10,10,30,10,30,20-10,10,10,30,10,10,10,10,10,00,00,00,10,10,10,10,10,10,10,20-10,10,10,10,10,10,10,10,10,10,10,10,10,10,10,10,10,30,10,10-10,10,10,30,10,30,30,30,30,30,10,30,30,30,30,30,30,30,10,20-10,10,30,30,30,30,30,30,30,30,30,30,30,30,30,10,30,30,30,20-10,10,30,30,30,30,10,30,30,30,30,30,10,30,30,30,30,30,30,10-10,10,30,30,30,30,30,30,30,30,30,30,30,30,30,30,30,30,30,10-10,30,30,30,30,30,30,30,30,30,30,30,10,30,30,30,30,10,30,10-10,10,30,10,30,30,30,30,30,30,30,30,30,10,30,30,30,30,30,10-10,30,30,30,30,30,30,30,30,30,30,30,30,30,30,30,30,30,30,10-10,30,30,30,10,30,30,10,30,30,30,10,30,30,30,30,30,30,30,10-10,30,10,30,30,30,30,30,30,30,30,30,30,30,30,10,30,30,30,10-10,30,30,30,30,10,30,30,30,10,30,30,30,30,30,30,30,30,30,10-10,30,30,30,30,30,30,30,30,30,30,10,30,30,10,30,30,30,30,10-10,30,10,30,30,30,30,30,30,30,10,30,30,30,30,10,30,10,30,10-10,30,30,30,30,30,10,30,30,30,30,30,10,30,30,30,30,30,30,10-10,10,10,10,10,10,10,10,10,10,10,10,10,10,10,10,10,10,10,10

1
Blossom_town2

10,10,10,10,03,23,01,01,10,01,10,10,10,10,20,20,20,20,20,20-10,10,10,10,03,23,10,10,10,10,30,10,01,30,10,10,30,10,10,20-10,10,10,30,03,23,30,10,10,10,10,10,01,20,10,10,10,10,10,20-10,10,10,10,03,23,10,10,10,10,10,10,00,10,10,10,30,10,30,20-10,10,10,30,03,23,00,00,00,00,00,00,00,05,16,25,02,12,12,12-10,10,10,10,03,23,00,00,00,00,00,00,00,07,17,27,03,45,14,14-10,10,10,30,03,44,12,12,12,12,12,12,69,69,69,69,34,23,10,20-10,10,30,01,04,14,14,14,14,14,35,45,611,611,611,611,35,23,30,20-10,10,01,01,01,30,10,30,30,30,03,23,01,00,00,00,03,23,30,10-10,10,01,01,30,30,30,30,30,30,03,23,01,30,30,30,03,23,30,10-10,30,01,01,30,30,30,30,30,30,03,23,01,30,30,30,03,23,30,10-10,10,01,10,30,30,30,30,30,30,03,23,30,10,30,30,03,23,30,10-10,00,30,30,30,30,30,30,30,00,03,44,12,12,12,12,34,23,00,00-41,51,30,30,02,13,12,12,12,12,34,45,14,14,14,14,14,24,00,51-40,50,00,00,04,14,14,14,14,14,14,24,00,30,30,10,30,30,00,50-41,51,41,00,30,10,30,30,30,10,30,30,00,00,30,30,30,30,00,51-40,50,40,00,00,00,00,00,00,00,30,00,00,00,00,00,00,00,00,50-41,51,41,51,41,51,41,51,41,51,41,51,41,51,41,51,41,51,41,51-40,50,40,50,40,50,40,50,40,50,40,50,40,50,40,50,40,50,40,50-41,51,41,51,41,51,41,51,41,51,41,51,41,51,41,51,41,51,41,51

1
Blossom_town3

41,51,41,51,41,00,41,51,41,51,41,51,41,51,41,51,41,51,41,51-62,50,62,50,62,00,62,50,62,50,40,50,62,50,62,50,62,50,62,50-10,10,10,30,10,00,41,51,41,51,10,10,10,20,10,10,41,51,41,51-00,00,00,00,00,00,00,00,00,00,00,00,00,00,00,00,40,50,62,50-10,10,10,30,10,01,01,01,00,00,00,00,10,10,10,10,00,51,41,51-10,10,10,10,10,10,10,01,00,10,10,10,10,10,10,10,00,00,00,50-10,10,10,30,10,30,30,30,30,30,10,30,30,30,30,30,00,30,00,51-10,10,30,02,12,12,12,22,30,30,30,30,30,30,30,10,00,00,00,50-10,10,30,03,45,14,14,24,30,30,30,30,10,30,30,30,00,00,00,51-10,01,30,03,23,30,30,30,30,30,30,30,30,30,30,00,00,50,62,50-10,01,01,03,23,30,30,30,30,30,30,30,10,30,30,30,00,10,41,51-10,01,01,03,23,30,30,30,30,30,30,30,30,10,30,30,00,00,00,50-10,30,02,34,44,12,12,12,12,12,12,22,30,30,30,30,01,01,00,51-10,30,03,45,14,14,14,35,45,14,14,24,30,30,30,30,30,30,00,50-10,30,03,23,30,01,01,03,23,30,30,30,30,30,30,10,30,30,00,51-10,30,631,731,30,10,01,03,23,10,30,08,18,18,28,30,00,00,00,50-12,12,34,23,30,30,30,03,23,30,30,09,19,19,48,28,00,00,00,51-14,14,14,24,30,30,30,03,23,30,10,09,19,19,19,29,00,50,62,50-10,30,30,30,30,30,10,03,23,30,30,010,110,110,110,210,00,30,41,51-10,10,10,10,10,10,10,03,23,10,10,10,10,10,10,10,00,52,62,50

1
Blossom_town4

10,10,10,10,10,10,10,10,03,23,10,10,10,10,20,20,20,20,20,20-10,10,10,10,10,10,10,10,03,23,30,10,10,30,10,10,30,10,10,20-10,10,10,30,10,10,30,10,03,23,10,10,10,20,10,10,10,10,10,20-10,10,01,10,10,10,10,10,03,23,10,10,10,10,10,01,01,10,30,20-10,10,01,30,02,12,12,12,34,44,12,12,12,22,10,01,10,10,10,20-10,10,01,10,03,45,14,14,14,14,14,14,35,23,10,10,10,30,10,10-10,10,10,30,03,23,02,12,12,12,12,22,03,23,30,30,30,30,10,20-10,10,30,30,03,23,03,00,13,13,00,23,03,23,30,10,30,30,30,20-10,10,30,30,03,23,03,00,00,13,00,23,03,23,30,30,30,30,30,10-10,10,30,30,03,23,03,00,13,13,00,23,03,23,30,30,30,30,30,10-10,30,30,30,03,23,03,13,13,13,13,23,03,23,30,30,30,10,30,10-10,10,30,10,03,44,12,12,12,12,12,12,34,23,30,30,30,30,30,10-10,30,30,30,04,14,14,14,35,45,14,14,14,24,30,30,30,30,30,10-10,30,30,30,10,30,01,01,03,23,01,10,01,30,30,30,30,30,30,10-10,30,10,30,30,30,01,01,03,23,01,30,30,30,30,10,30,30,30,10-10,30,30,30,02,12,12,12,34,44,12,12,22,30,30,30,30,30,30,10-10,30,30,30,03,45,14,14,14,14,14,35,44,12,12,12,12,12,12,12-10,30,10,30,03,23,01,01,30,30,10,04,14,14,14,14,14,14,14,14-10,30,30,30,03,23,10,30,30,30,30,30,10,01,30,30,30,10,10,10-10,10,10,10,03,23,10,10,10,10,10,10,10,01,01,10,10,10,10,10

1
GreenGras16x25Dontedit

2345,2345,2345,2345,2345,2345,2345,2345,2345,2345,2345,2345,2345,2345,2345,2345-2345,2345,2345,2345,2345,2345,2345,2345,0344,2345,2345,2345,2345,2345,2345,2345-2345,2345,2345,2345,2345,2345,2345,0344,2345,2345,2345,2345,2345,2345,2345,2345-2345,2345,2345,0344,2345,2345,2345,2345,2345,2345,2345,2345,2345,2345,2345,2345-2345,2345,2345,2345,2345,2345,2345,2345,2345,2345,2345,2345,2345,2345,2345,2345-2345,2345,2345,2345,2345,2345,0344,2345,2345,2345,2345,2345,2345,2345,2345,2345-2345,2345,2345,2345,0344,2345,2345,2345,2345,2345,2345,2345,2345,2345,2345,2345-2345,2345,0344,2345,2345,2345,2345,2345,2345,2345,2345,2345,2345,2345,2345,2345-2345,2345,2345,2345,2345,2345,2345,2345,2345,2345,2345,2345,2345,2345,2345,2345-2345,2345,2345,2345,2345,0344,2345,2345,2345,2345,2345,2345,0344,2345,2345,2345-2345,2345,2345,2345,2345,2345,2345,2345,0344,2345,2345,2345,2345,2345,2345,2345-2345,2345,2345,2345,2345,2345,2345,0344,2345,2345,2345,2345,2345,2345,2345,2345-2345,2345,2345,0344,2345,0344,2345,0344,2345,2345,2345,2345,0344,2345,2345,2345-2345,2345,2345,2345,2345,2345,0344,2345,2345,2345,2345,2345,2345,2345,2345,2345-2345,2345,2345,2345,2345,2345,0344,2345,2345,2345,2345,2345,2345,2345,2345,2345-2345,2345,2345,2345,0344,2345,2345,2345,2345,0344,2345,0344,2345,2345,2345,2345-2345,2345,2345,2345,0344,0344,0344,0344,0344,0344,0344,0344,2345,2345,0344,2345-2345,0344,2345,2345,0344,0344,0344,0344,0344,0344,0344,2345,2345,2345,2345,2345-2345,2345,0344,2345,0344,0344,0344,0344,0344,0344,0344,0344,2345,2345,2345,2345-2345,2345,0344,2345,0344,0344,0344,0344,0344,0344,0344,2345,2345,2345,2345,2345-0344,0344,2345,2345,0344,0344,0344,0344,0344,0344,0344,2345,2345,2345,2345,2345-0344,0344,2345,2345,2345,2345,2345,2345,2345,2345,2345,2345,2345,2345,2345,2345-0344,0344,2345,0344,2345,2345,2345,2345,2345,2345,2345,2345,2345,2345,0344,2345-0344,0344,0344,0344,2345,0344,0344,2345,0344,2345,2345,2345,2345,2345,2345,2345-0344,0344,0344,0344,0344,0344,2345,0344,2345,2345,2345,2345,2345,2345,2345,2345

1
Woods of Glory

2345,40,2345,41,51,41,51,510,710,01,01,01,2345,2345,2345,2345-2345,2345,2345,40,50,40,50,510,410,69,79,2345,2345,2345,2345,2345-2345,40,2345,41,51,41,51,511,611,311,710,01,2345,2345,2345,2345-2345,2345,2345,42,52,42,52,00,00,510,710,2345,2345,2345,2345,2345-2345,40,2345,59,69,69,69,69,69,310,710,2345,2345,2345,2345,2345-2345,2345,2345,510,411,611,611,611,611,611,711,2345,10,10,2345,2345-2345,40,2345,510,710,01,01,00,00,2345,2345,01,2345,2345,2345,2345-2345,2345,0344,510,710,01,01,00,00,2345,2345,2345,2345,2345,2345,2345-2345,40,2345,510,710,01,00,00,00,2345,2345,2345,2345,2345,2345,10-2345,40,2345,510,710,01,01,00,00,2345,2345,2345,0344,2345,2345,2345-2345,40,2345,510,410,69,79,00,00,2345,2345,10,2345,2345,2345,2345-2345,2345,2345,511,611,311,710,00,00,2345,2345,2345,2345,2345,2345,10-2345,40,2345,0344,2345,510,710,00,00,2345,2345,2345,0344,2345,2345,2345-2345,2345,2345,2345,2345,510,410,69,69,69,69,79,2345,2345,2345,2345-2345,40,2345,10,2345,511,611,611,611,611,311,710,2345,2345,2345,2345-2345,2345,2345,2345,0344,01,01,01,00,0344,510,710,2345,2345,2345,2345-2345,40,2345,2345,0344,01,10,01,00,0344,510,710,2345,2345,0344,2345-2345,0344,2345,10,0344,0344,0344,00,00,10,510,710,2345,2345,2345,2345-2345,40,0344,2345,0344,0344,0344,00,00,0344,510,710,2345,2345,2345,2345-2345,2345,0344,2345,0344,0344,0344,59,69,69,310,710,2345,2345,2345,2345-0344,40,2345,2345,0344,0344,0344,510,411,611,611,711,2345,2345,2345,2345-0344,0344,2345,2345,2345,2345,2345,510,710,2345,2345,2345,2345,2345,2345,2345-0344,40,2345,0344,2345,2345,2345,510,710,2345,2345,2345,2345,2345,0344,2345-0344,0344,0344,0344,2345,0344,0344,510,710,2345,2345,2345,10,2345,2345,2345-0344,40,0344,40,0344,0344,2345,510,710,2345,2345,2345,2345,2345,2345,50
1;1;90000
1
woood

10,10,10,01,01,10,01,10,01,10,10,10,03,13,23,20,20,20,20,20-10,01,10,10,01,10,01,01,10,01,30,10,03,13,23,10,30,10,10,20-01,10,01,30,01,10,01,01,01,10,01,10,03,13,23,10,10,10,10,20-00,10,10,10,10,10,01,10,01,01,01,10,03,13,23,10,30,10,30,20-01,01,10,01,10,01,01,10,10,00,00,00,03,13,23,10,10,10,10,20-10,10,01,01,10,01,10,02,12,12,12,12,34,13,23,10,10,30,10,10-10,01,10,01,01,01,01,03,13,13,13,13,13,13,23,30,30,30,10,20-01,10,01,01,30,01,01,03,13,45,14,14,14,14,24,10,30,30,30,20-10,01,30,30,01,01,10,03,13,23,30,30,10,30,30,00,20,20,30,10-01,10,01,30,01,30,01,04,14,24,30,30,30,30,00,00,30,20,30,10-10,01,01,30,01,01,30,00,00,00,30,30,10,30,30,30,30,20,30,10-10,01,01,01,01,01,01,02,12,22,30,30,30,10,10,30,30,30,30,10-10,01,30,01,01,30,30,03,13,23,30,30,30,30,10,30,133,30,20,10-10,30,01,30,01,30,01,03,13,23,30,10,30,30,30,133,30,30,30,10-01,30,10,01,30,01,01,03,13,23,30,30,30,30,30,30,30,30,30,10-01,30,01,30,01,10,01,03,13,44,12,12,12,22,30,30,30,30,30,10-10,30,01,30,30,01,30,03,13,13,13,13,13,23,10,30,30,30,30,10-10,01,01,30,01,30,30,04,14,14,14,35,13,23,30,10,30,10,30,10-01,01,30,01,30,30,01,30,30,30,30,03,13,23,30,30,30,30,30,10-10,10,01,10,01,10,01,10,10,10,10,03,13,23,10,10,10,10,10,10

1
wood

00,00,00,00,00,00,01,01,01,00,01,00,510,610,710,01,00,01,01,00,00,00,00,00,00-00,00,00,00,00,00,01,01,00,01,00,00,511,611,711,00,00,01,00,01,00,00,00,00,00-00,00,00,00,00,01,01,01,01,00,01,00,09,19,29,01,01,00,01,00,00,00,01,00,00-00,00,00,01,08,18,18,18,18,18,18,18,38,19,19,18,18,18,28,01,00,01,00,00,00-00,00,00,00,09,49,110,110,110,110,110,110,110,110,110,110,110,39,29,00,01,01,00,10,00-00,00,00,00,09,29,01,00,00,00,01,00,01,01,00,00,01,09,29,00,01,01,00,00,00-00,00,10,01,09,29,00,00,01,01,01,01,00,00,01,01,00,09,29,00,00,01,00,00,00-00,00,00,00,09,29,01,00,00,00,01,01,01,01,01,01,00,09,29,01,00,01,00,10,00-00,00,10,00,010,210,00,00,01,00,00,01,00,01,01,01,00,010,210,00,01,01,01,00,00-00,00,00,00,59,79,00,01,00,00,01,01,01,01,01,00,00,59,79,00,00,01,00,10,00-00,00,00,00,510,710,01,01,01,00,00,00,01,01,00,01,01,510,710,01,01,01,612,712,00-00,10,00,01,510,710,01,01,01,01,01,00,00,01,00,01,00,511,711,00,00,01,614,714,00-00,00,00,00,510,710,00,01,00,00,00,01,01,01,00,01,01,08,28,00,01,01,01,00,00-00,00,00,00,511,711,01,01,01,01,00,01,00,01,01,00,01,09,29,01,00,00,01,00,00-00,10,00,01,00,01,00,00,01,00,01,01,00,00,00,01,01,09,48,18,28,00,01,00,10-00,00,10,01,00,00,01,01,00,01,00,00,01,00,01,01,01,09,49,110,210,01,00,00,00-00,00,10,00,01,00,00,00,01,00,00,01,01,01,00,01,00,09,29,00,00,00,00,00,00-00,00,10,00,01,01,01,00,00,01,00,01,00,00,01,01,00,09,29,01,00,00,01,00,00-00,10,00,01,01,00,00,01,01,08,18,28,59,69,69,79,08,38,29,01,00,00,10,10,00-00,00,01,01,01,01,01,01,01,09,49,210,511,611,611,711,010,110,210,00,00,00,00,10,00-00,00,00,00,00,00,00,00,00,09,29,00,00,00,01,00,00,01,01,00,00,00,00,00,00-01,00,00,01,01,00,00,01,01,09,29,00,00,01,00,00,01,00,00,00,00,00,00,00,00-00,00,00,00,01,00,00,00,00,010,210,00,00,00,00,01,01,00,00,00,00,00,00,00,00-00,68,78,00,00,00,00,01,00,59,79,00,00,00,00,00,00,00,00,00,00,00,00,00,00-00,00,00,00,00,00,00,00,00,510,710,00,00,00,00,00,00,00,00,00,00,00,00,00,00

1
